%%%%%%%%%%%%%%%%%%%%%%%%%%%%%%%%%%%%%%%%%%%%%%%%%%%%%%%%%%%%%%%%%%%%%%%%%%
%       % % %           %   %     %          % % %           %   %     % %
% %%%%%%% % %%% % %%% %%% %%%%%%% %    %%%%%%% % %%% % %%% %%% %%%%%%% % %
%       %       % %     %     % %            %       % %     %     % %   %
%%%%% %%%%% %%% % % % %%% %%%%%   %%% %%%% %%%%% %%% % % % %%% %%%%% % %%%
%   % % % %   % % % %   % %   % %        % % % %   % % % %   % %   % %   %
% %%% % % % %%% %%%%% %%% % %%% %%%    %%% % % % %%% %%%%% %%% % %%% %%% %
%       %     %   %   %     % % %    %       %     %   %   %     % % %   %
%%% %%%%%%%%% %%%%%%% %%% %%% % % %  %%% %%%%%%%%% %%%%%%% %%% %%% % % % %
%             %       % %   %     %  %             %       % %   %     % %
% % %%%%% % %%% % % %%% % %%% %%% %    % %%%%% % %%% % % %%% % %%% %%% % %
% % %     % % % % %     %   % % % %    % %     % % % % %     %   % % % % %
% % % %%%%%%% % %%%%%%%%% %%% % %%%    % % %%%%%%% % %%%%%%%%% %%% % %%% %
% % % %     %   %     %     %   %      % % %     %   %     %     %   %   %
%%% %%% % %%%%% %%%%% %%% %%% %%%%%   %% %%% % %%%%% %%%%% %%% %%% %%%%% %
%     % % %     % %     % %   % % %        % % %     % %     % %   % % % %
% % % % % %%% %%% %%% %%% % % % % %    % % % % %%% %%% %%% %%% % % % % % %
% % % % %                 % % %        % % % %                 % % %     %
%%% %%%%%%% % % %%%%% %%% % %%% %%%%  %% %%%%%%% % % %%%%% %%% % %%% %%%%%
%       % % % %     %   %     % %            % % % %     %   %     % %   %
%%%%% % % %%%%%%%%% %%%%%%%%%%% %%%    %%% % % %%%%%%%%% %%%%%%%%%%% % %%%
%   % %           % %     %   % %        % %           % %     %   % %   %
% %%% %%%%% %%%%%%%%% %%%%% % % %%% %   %% %%%%% %%%%%%%%% %%%%% % % %%% %
% %   %      %        %     %       % %           %        %     %       %
% % % %%%%% %%% % % % % %%%%%%%%%%%%% % %% %%%%% %%% % % % % %%%%%%%%%%%%%
% % %   %     % % % %       %   % % % % %    %     % % % %       %   % % %
% % %%% %%% % % % %%%%%%%%% %%% % % % % %%%  %%% % % % %%%%%%%%% %%% % % %
% %   % %   % % %   % %   % % %     %      % %   % % %   % %   % % %     %
% %%% %%% %%%%% %%% % % %%%%% % %%%%% %%%  %%% %%%%% %%% % % %%%%% % %%%%%
%       %   %     % %     %   % %   %        %   %     % %     %   % %   %
%%% % %%%%% %%%%% %%% %%% % %%% % %%%%% %  %%%%% %%%%% %%% %%% % %%% % %%%
% % % % % % % %     % %   % %   % % % % %  % % % % %     % %   % %   % % %
% % %%% % % % % %%%%%%%%% % % % % % % % %%%  % % % % %%%%%%%%% % % % % % %
%   %   %   %                 %       % %    %   %                 %     %
% % % % %%% %%% %%%%%%% %%% %%% %%   %% %%%  %%% %%% %%%%%%% %%% %%% %%% %
%.% % %       %   %       %   % %  % %   %        %    %       %   % %  P%
%%%%%%%%%%%%%%%%%%%%%%%%%%%%%%%%%%%%%%%%%%%%%%%%%%%%%%%%%%%%%%%%%%%%%%%%%%
