%%%%%%%%%%%%%%%%%%%%%%%%%%%%%%%%%%%%%%%%%%%%%%%%%%%%%%%%%%%%%%%%%%%%%%%%%%%%%%%%%%%%%%%%%%%%%%%%%%%%%%%%%%%%%%%%%%%%%%%%%%%%%%%%%%%%%%%%%%%%%%%%%%%%
%       % % %           %   %     %          % % %           %   %     % %%       % % %           %   %     %          % % %           %   %     % %
% %%%%%%% % %%% % %%% %%% %%%%%%% %    %%%%%%% % %%% % %%% %%% %%%%%%% % %% %%%%%%% % %%% % %%% %%% %%%%%%% %    %%%%%%% % %%% % %%% %%% %%%%%%% % %
%       %       % %     %     % %            %       % %     %     % %   %%       %       % %     %     % %            %       % %     %     % %   %
%%%%% %%%%% %%% % % % %%% %%%%%   %%% %%%% %%%%% %%% % % % %%% %%%%% % %%%%%%%% %%%%% %%% % % % %%% %%%%%   %%% %%%% %%%%% %%% % % % %%% %%%%% % %%%
%   % % % %   % % % %   % %   % %        % % % %   % % % %   % %   % %   %%   % % % %   % % % %   % %   % %        % % % %   % % % %   % %   % %   %
% %%% % % % %%% %%%%% %%% % %%% %%%    %%% % % % %%% %%%%% %%% % %%% %%% %% %%% % % % %%% %%%%% %%% % %%% %%%    %%% % % % %%% %%%%% %%% % %%% %%% %
%       %     %   %   %     % % %    %       %     %   %   %     % % %   %%       %     %   %   %     % % %    %       %     %   %   %     % % %   %
%%% %%%%%%%%% %%%%%%% %%% %%% % % %  %%% %%%%%%%%% %%%%%%% %%% %%% % % % %%%% %%%%%%%%% %%%%%%% %%% %%% % % %  %%% %%%%%%%%% %%%%%%% %%% %%% % % % %
%             %       % %   %     %  %             %       % %   %     % %%             %       % %   %     %  %             %       % %   %     % %
% % %%%%% % %%% % % %%% % %%% %%% %    % %%%%% % %%% % % %%% % %%% %%% % %% % %%%%% % %%% % % %%% % %%% %%% %    % %%%%% % %%% % % %%% % %%% %%% % %
% % %     % % % % %     %   % % % %    % %     % % % % %     %   % % % % %% % %     % % % % %     %   % % % %    % %     % % % % %     %   % % % % %
% % % %%%%%%% % %%%%%%%%% %%% % %%%    % % %%%%%%% % %%%%%%%%% %%% % %%% %% % % %%%%%%% % %%%%%%%%% %%% % %%%    % % %%%%%%% % %%%%%%%%% %%% % %%% %
% % % %     %   %     %     %   %      % % %     %   %     %     %   %   %% % % %     %   %     %     %   %      % % %     %   %     %     %   %   %
%%% %%% % %%%%% %%%%% %%% %%% %%%%%   %% %%% % %%%%% %%%%% %%% %%% %%%%% %%%% %%% % %%%%% %%%%% %%% %%% %%%%%   %% %%% % %%%%% %%%%% %%% %%% %%%%% %
%     % % %     % %     % %   % % %        % % %     % %     % %   % % %        % % %     % %     % %   % % %        % % %     % %     % %   % % % %
% % % % % %%% %%% %%% %%% % % % % %    % % % % %%% %%% %%% %%% % % % % % %% % % % % %%% %%% %%% %%% % % % % %    % % % % %%% %%% %%% %%% % % % % % %
% % % % %                 % % %        % % % %                 % % %     %% % % % %                 % % %        % % % %                 % % %     %
%%% %%%%%%% % % %%%%% %%% % %%% %%%%  %% %%%%%%% % % %%%%% %%% % %%% %%%%%%%% %%%%%%% % % %%%%% %%% % %%% %%%%  %% %%%%%%% % % %%%%% %%% % %%% %%%%%
%       % % % %     %   %     % %            % % % %     %   %     % %   %%       % % % %     %   %     % %            % % % %     %   %     % %   %
%%%%% % % %%%%%%%%% %%%%%%%%%%% %%%    %%% % % %%%%%%%%% %%%%%%%%%%% % %%%%%%%% % % %%%%%%%%% %%%%%%%%%%% %%%    %%% % % %%%%%%%%% %%%%%%%%%%% % %%%
%   % %           % %     %   % %        % %           % %     %   % %   %%   % %           % %     %   % %        % %           % %     %   % %   %
% %%% %%%%% %%%%%%%%% %%%%% % % %%% %   %% %%%%% %%%%%%%%% %%%%% % % %%% %% %%% %%%%% %%%%%%%%% %%%%% % % %%% %   %% %%%%% %%%%%%%%% %%%%% % % %%% %
% %   %      %        %     %       % %           %        %     %          %   %      %        %     %       % %           %        %     %       %
% % % %%%%% %%% % % % % %%%%%%%%%%%%% % %% %%%%% %%% % % % % %%%%%%%%%%%%%% % % %%%%% %%% % % % % %%%%%%%%%%%%% % %% %%%%% %%% % % % % %%%%%%%%%%%%%
% % %   %     % % % %       %   % % % % %    %     % % % %       %   % % %% % %   %     % % % %       %   % % % % %    %     % % % %       %   % % %
% % %%% %%% % % % %%%%%%%%% %%% % % % % %%%  %%% % % % %%%%%%%%% %%% % % %% % %%% %%% % % % %%%%%%%%% %%% % % % % %%%  %%% % % % %%%%%%%%% %%% % % %
% %   % %   % % %   % %   % % %     %      % %   % % %   % %   % % %     %% %   % %   % % %   % %   % % %     %      % %   % % %   % %   % % %     %
% %%% %%% %%%%% %%% % % %%%%% % %%%%% %%%  %%% %%%%% %%% % % %%%%% % %%%%%% %%% %%% %%%%% %%% % % %%%%% % %%%%% %%%  %%% %%%%% %%% % % %%%%% % %%%%%
%       %   %     % %     %   % %   %        %   %     % %     %   % %   %%       %   %     % %     %   % %   %        %   %     % %     %   % %   %
%%% % %%%%% %%%%% %%% %%% % %%% % %%%%% %  %%%%% %%%%% %%% %%% % %%% % %%%%%% % %%%%% %%%%% %%% %%% % %%% % %%%%% %  %%%%% %%%%% %%% %%% % %%% % %%%
% % % % % % % %     % %   % %   % % % % %    % % % %     % %   % %   % % %% % % % % % % %     % %   % %   % % % % %  % % % % %     % %   % %   % % %
% % %%% % % % % %%%%%%%%% % % % % % % % %%%  % % % % %%%%%%%%% % % % % % %% % %%% % % % % %%%%%%%%% % % % % % % % %    % % % % %%%%%%%%% % % % % % %
%   %   %   %                 %       % %    %   %                 %     %%   %   %   %                 %       % %    %   %                 %     %
% % % % %%% %%% %%%%%%% %%% %%% %%   %% %%%  %%% %%% %%%%%%% %%% %%% %%% %% % % % %%% %%% %%%%%%% %%% %%% %%   %% %%   %%% %%% %%%%%%% %%% %%% %%% %
% % % % %                 %   %        % %   %                 % % %        % % % %                 % % %        % %   %                 %   %     %
%%% %%%%%%% % % %%%%% %%% % %%% %%%%  %% %%%%%%% % % %%%%% %%% % %%% %%%%%%%% %%%%%%% % % %%%%% %%% % %%% %%%%  %% %%%%%%% % % %%%%% %%% % %%% %%%%%
%       % % % %     %   %     % %            % % % %     %   %     % %   %%       % % % %     %   %     % %            % % % %     %   %     % %   %
%%%%% % % %%%%%%%%% %%%%%%%%%%% %%%    %%% % % %%%%%%%%% %%%%%%%%%%% % %%%%%%%% % % %%%%%%%%% %%%%%%%%%%% %%%    %%% % % %%%%%%%%% %%%%%%%%%%% % %%%
%   % %           % %     %   % %        % %           % %     %   % %   %%   % %           % %     %   % %        % %           % %     %   % %   %
% %%% %%%%% %%%%%%%%% %%%%% % % %%% %   %% %%%%% %%%%%%%%% %%%%% % % %%% %% %%% %%%%% %%%%%%%%% %%%%% % % %%% %   %% %%%%% %%%%%%%%% %%%%% % % %%% %
% %   %      %        %     %       % %           %        %     %       %% %   %      %        %     %       % %           %        %     %       %
% % % %%%%% %%% % % % % %%%%%%%%%%%%% % %% %%%%% %%% % % % % %%%%%%%%%%%%%% % % %%%%% %%% % % % % %%%%%%%%%%%%% % %% %%%%% %%% % % % % %%%%%%%%%%%%%
% % %   %     % % % %       %   % % % % %    %     % % % %       %   % % %% % %   %     % % % %       %   % % % % %    %     % % % %       %   % % %
% % %%% %%% % % % %%%%%%%%% %%% % % % % %%%  %%% % % % %%%%%%%%% %%% % % %% % %%% %%% % % % %%%%%%%%% %%% % % % % %%%  %%% % % % %%%%%%%%% %%% % % %
% %   % %   % % %   % %   % % %     %      % %   % % %   % %   % % %        %   % %   % % %   % %   % % %     %      % %   % % %   % %   % % %     %
% %%% %%% %%%%% %%% % % %%%%% % %%%%% %%%  %%% %%%%% %%% % % %%%%% % %%%%%% %%% %%% %%%%% %%% % % %%%%% % %%%%% %%%  %%% %%%%% %%% % % %%%%% % %%%%%
%       %   %     % %     %   % %   %        %   %     % %     %   % %   %%       %   %     % %     %   % %   %        %   %     % %     %   % %   %
%%% % %%%%% %%%%% %%% %%% % %%% % %%%%% %  %%%%% %%%%% %%% %%% % %%% % %%%%%% % %%%%% %%%%% %%% %%% % %%% % %%%%% %  %%%%% %%%%% %%% %%% % %%% % %%%
% % % % % % % %     % %   % %   % % % % %  % % % % %     % %   % %   % % %% % % % % % % %     % %   % %   % % % % %  % % % % %     % %   % %   % % %
% % %%% % % % % %%%%%%%%% % % % % % % % %%%  % % % % %%%%%%%%% % % % % % %% % %%% % % % % %%%%%%%%% % % % % % % % %%%  % % % % %%%%%%%%% % % % % % %
%   %   %   %                 %       % %    %   %                 %     %%   %   %   %                 %       % %    %   %                 %     %
% % % % %%% %%% %%%%%%% %%% %%% %%   %% %%%  %%% %%% %%%%%%% %%% %%% %%% %% % % % %%% %%% %%%%%%% %%% %%% %%   %% %%%  %%% %%% %%%%%%% %%% %%% %%% %
%.% % %       %   %       %   % %  % %   %        %    %       %   % %   %  %%% %       %   %       %   % %  % %   %        %    %       %   % %  P%
%%%%%%%%%%%%%%%%%%%%%%%%%%%%%%%%%%%%%%%%%%%%%%%%%%%%%%%%%%%%%%%%%%%%%%%%%%%%%%%%%%%%%%%%%%%%%%%%%%%%%%%%%%%%%%%%%%%%%%%%%%%%%%%%%%%%%%%%%%%%%%%%%%%%