%%%%%%%%%%%%%%%%%%%%%%%%%%%%%%%%%%%%%%%%%%%%%%%%%%%%%%%%%%%%%%%%%%%%%%%%%%%%%%%%%%%%%%%%%%%%%%%%%%%%%%%%%%%%
%                                                 %                                                       P%
% %%%%%%%%%%%%%%%%%%%%%%% %%%%%%%%   %%%%%%%%%%%%%%%%%%%%%%%   %%%%%%     %%%%%%%%%%%%%%%%%%%%%%%  %%%%%%% %
% %%   %   %      %%%%%%%   %%        %%               %%%%%     %        %%   %   %      %%%%%%%   %      %
% %% % % % % %%%% %%%%%%%%% %% %%%%    %% % % % % %%%% %%%%%%%%  %  %%%%% %% % % % % %%%% %%%%%%%%% %  %%%%%
% %% % % % %             %% %%         %% % % % %             %  %      % %% % % % %             %% %      %
% %% % % % % % %%%%  %%%    %%%%%%     %% % % % %   %%%%         %%%%%% % %% % % % % % %%%%  %      %%%%%% %
% %  % % %   %    %% %%%%%%%%             %            %   %%%%           %% % % %   %    %% %%%%%%%%      % 
% %% % % %%%%%%%% %%        %% %%%%    %% %   %%%%%%%% %%        %% %%%%% %% % % %%%%%%%% %%        %% %%%%%
% %% %   %%       %%%%%%%%% %%     %   %% %   %%       %%%%%%%%% %%     % %% %   %%       %%%%%%%%% %%     %
%    %%%%%% %%%%%%%      %% %%%%%% %      %%%%%% %%%%%%%      %% %%%%%% %    %%%%%% %%%%%%%      %% %%%%%% %
%%%%%%      %       %%%% %% %      %  %%%%%      %       %%%% %% %      %%%%%%      %       %%%% %% %      %
%      %%%%%% %%%%% %    %% %% %%%%%        %%%%%% %%%%% %    %% %% %%%%%      %%%%%% %%%%% %    %% %% %%%%%
% %%%%%%      %       %%%%% %%     %   %%%%%%      %       %%%%% %%     % %%%%%%      %       %%%%% %%     %
%        %%%%%% %%%%%%%%%%% %%  %% %          %%%%%% %%%%%%%%%%% %%  %% %        %%%%%% %%%%%%%%%%% %%  %% %
%%%%%%%%%%                  %%%%%% %%%%%%  %%%%                  %%%%%% %%%%%%%%%%                  %%%%%% %
%.         %%%%%%%%%%%%%%%%        %            %%%%%%%%%%%%%%%%        %          %%%%%%%%%%%%%%%%        %
%%%%%%%%%%%%%%%%%%%%%%%%%%%%%%%%%%%%%%%%%%%%%%%%%%%%%%%%%%%%%%%%%%%%%%%%%%%%%%%%%%%%%%%%%%%%%%%%%%%%%%%%%%%%